0 0 0 0 0 0 0 0 0 0
0 1 13 1 0 1 4 1 1 0
0 1 1 3 1 0 1 1 1 0
0 1 5 1 0 12 6 1 1 0
0 1 1 2 1 0 1 1 1 0
0 1 1 1 0 1 7 1 1 0
0 0 0 0 0 0 0 0 0 0