2 3 0 0 1 1 0 0 4 5
0 0 0 1 1 1 1 0 0 0
0 0 1 1 7 8 1 1 0 0
0 1 1 1 1 1 1 1 1 0
1 1 1 1 1 1 1 1 1 1
0 0 0 0 0 0 0 0 0 0
1 1 1 1 1 1 1 1 1 1