2 3 0 0 1 1 0 11 4 5
0 1 1 1 1 1 1 1 1 0
1 12 1 1 1 1 1 1 1 1
0 10 0 0 0 0 0 0 0 0
1 1 1 1 1 1 1 1 1 1
0 0 0 0 0 9 0 13 0 0