1 1 1 1 1 1 1 1 1 1
1 8 11 0 7 0 0 0 0 1
1 1 1 1 1 1 1 1 6 1
1 0 0 0 5 0 0 0 0 1
1 4 1 1 1 1 1 1 1 1
1 0 0 0 10 3 0 0 0 1
1 1 1 1 1 1 1 1 2 1