1 1 1 1 1 1 1 1 1 1
1 8 0 0 7 0 0 0 0 1
1 1 1 1 1 1 1 1 6 1
1 0 0 0 5 11 0 0 0 1
1 4 1 1 1 1 1 1 1 1
1 0 0 0 0 3 0 0 0 1
1 1 1 1 1 1 1 1 2 10