1 1 1 1 1 1 1 1 1 8
1 0 6 0 1 0 7 0 1 0
1 0 1 0 1 0 1 0 1 0
1 0 1 0 4 0 1 0 3 0
1 5 1 1 1 1 1 1 1 1
0 9 0 0 0 0 0 0 0 0
