1 2 1 6 1 5 1 2 1 6
0 1 0 1 0 1 0 1 0 1
1 3 1 2 1 4 1 8 1 5
0 1 0 1 0 1 0 1 0 1
1 5 1 5 1 3 1 7 1 4
1 5 1 4 1 2 1 6 1 3
0 0 0 9 0 0 0 0 0 0
