1  1  1  1  1  1  1  1  1  1
7  0  0  2  1  3  0  0  0  0
1  1  1  0  1  0  1  1  1  1
0  1  0  0  1  0  0  1  1  0
6  0  0  0  1  0  0  4  5  0
0  1  0  0  1  0  0  1  1  0
1  1  1  0  0  0  1  1  1  1
